WWWWWWWWWWWWWWWWWWWWWWWWWWWWWWWWW
W---------------W---------------W
W-WWWWWW-WWWWWW-W-WWWWWW-WWWWWW-W
W-------C---------------C-------W
W-WWWWWW-W-WWWWWWWWWWW-W-WWWWWW-W
W--------W------W------W--------W
WWWWWWWW-WWWWWW-W-WWWWWW-WWWWWWWW
       W-W--C-------C--W-W       
WWWWWWWW-W-WWWTTTTTWWW-W-WWWWWWWW
-----------W         W-----------
WWWWWWWW-W-W 1  2  3 W-W-WWWWWWWW
-----------W    4    W-----------
WWWWWWWW-W-WWWWWWWWWWW-W-WWWWWWWW
       W-W--C-------C--W-W       
WWWWWWWW-WWWWWW-W-WWWWWW-WWWWWWWW
W--------WP-----W------W--------W
W-WWWWWW-W-WWWWWWWWWWW-W-WWWWWW-W
W-------C---------------C-------W
W-WWWWWW-WWWWWW-W-WWWWWW-WWWWWW-W
W---------------W---------------W
WWWWWWWWWWWWWWWWWWWWWWWWWWWWWWWWW